1..111111111111111111111111111111111111111111111111111111111111111111111111
1........0................................................................1
1........0................................................................1
1........111111111111111111111............................................1
1........0............................1.........111111111111111...........1
1........1.............................1......................1...........1
1........1..............................1............1....................1
1........111111111111111111111...........1...........1111111111111111.....1
1........1................................1...............................1
1........1................................11111111........................1
1........1.......................................1........................1
1........1...............111111111111111111......1.........1..............1
1........1...............1.......................1.........1..............1
1........1...............1.......................1.........1..............1
1........1...............1.......................1.........1111111........1
1........1...............1.......................1...............1........1
1........1...............1.......................................1........1
1.....1..................1..111111111111111..............1.1111..1........1
1.....1..................1................1...............................1
1.....1..................1................1...........111111111...........1
1.....111111111..........1................1...................1...........1
1........................1....................................1...........1
1........................111111111111111111...................1...........1
1.............................................................1...........1
1.............................................................1...........1
1..............11....111111...................................1...........1
1.............1.1.....................11111111111.............1...........1
1............1..1.........1...................................1...........1
1...............1.........1...................................1...........1
1....11111......1....111111.........1.........................1...........1
1...............1.........1.........1...........1.............1...........1
1...............1.........1.........1...........1.............1...........1
1...............1.........1.........1...........1.............1...........1
1...............1...................1.......... 111111111111111.......... 1
1...............1....111111.........1.....................................1
1...................................111111111.............................1
1.........................................................................1
1.........................................................................1
111111111111111111111111111111111111111111111111111111111111111111111111.11

